%%%%%%%
%    .%              
%     % 
%  R  %       
%     %
%.    %             
%%%%%%%