%%%%%%%%%%%%%%%%%%%%%%%%
%                     .%
%                      % 
% %                    % 
%  %                   % 
%   %                  % 
%     %                %
%      %               %
%       %              % 
%        %             % 
%         %            % 
%          %           % 
% R         %          %               
%%%%%%%%%%%%%%%%%%%%%%%%