%%%%%%%
%     %              
%     % 
%  R  %       
%     %
%.    %             
%%%%%%%